R 480 300
NO ./textures/wolfenstein/north.xpm
SO ./textures/wolfenstein/south.xpm
WE ./textures/wolfenstein/west.xpm
EA ./textures/wolfenstein/east.xpm

S ./textures/wolfenstein/sprite.xpm
F 220,100,0
C 225,30,0

A 400, 0

1111111111111111111
10000000000000000W1
1000000000000000001
1000000002000000001
1000000000000000001
1000000000000000001
1111111111111111111